中澀	中渋 中澁
乘	乗
亂	乱
亙	亘
亞	亜
亞洲	亜州
人口社會減型過疎	人口社会減型過疎
佛	仏
來	来
個人攝影	個人撮影
個攝	個撮
個攝物	個撮物
假	仮
傳	伝
僞	偽
價	価
儉	倹
兒	児
內	内
兩	両
前澀	前渋 前澁
剎	刹
剩	剰
劍	剣
劑	剤
動畫攝影	動画撮影
動畫攝影者	動画撮影者
勞	労
勳	勲
勵	励
勸	勧
勻	匀
區	区
區劃	区画
區畫	区画
卷	巻
卻	却
參	参
台北輕鐵炭礦	台北軽鉄炭鉱
吳	呉
咒	呪
商品攝影	商品撮影
啞	唖
單	単
噓	嘘
嚙	噛
嚴	厳
囑	嘱
圈	圏
國	国
國民健康保險飛驒市民病院	国民健康保険飛騨市民病院 国民健康保険飛驒市民病院
圍	囲
圓	円
圖	図
團	団
堯仁	堯仁 尭仁
堯仁法親王	堯仁法親王 尭仁法親王
堯性	堯性 尭性
堯性法親王	堯性法親王 尭性法親王
增	増
墮	堕
壓	圧
壘	塁
壞	壊
壤	壌
壯	壮
壹	壱
壽	寿
大禰	大禰
奧	奥
奧飛驒	奥飛騨 奥飛驒
奬	奨
妝	粧
孃	嬢
學	学
宿禰	宿禰
寢	寝
實	実
寫	写
寫真攝影	写真撮影
寬	寛
寶	宝
將	将
專	専
對	対
小澀	小渋 小澁
少子型過疎	少子型過疎
屆	届
屬	属
山澀	山渋 山澁
峯	峰
峽	峡
嶽	岳
巖	巌
巢	巣
帶	帯
廁	厠
廢	廃
廣	広
廳	庁
彈	弾
彌	弥
彎	弯
彥	彦
徑	径
從	従
徵	徴
德	徳
恆	恒
悅	悦
惠	恵
惡	悪
惱	悩
慘	惨
應	応
懷	懐
戀	恋
戰	戦
戲	戯
戶	戸
戾	戻
拂	払
拔	抜
拜	拝
挾	挟
插	挿
揭	掲
搔	掻
搖	揺
搜	捜
摑	掴
擇	択
擊	撃
擔	担
據	拠
擴	拡
攝	摂
攝像	撮像
攝像素子	撮像素子
攝影	撮影
攝影所	撮影所
攝影會	撮影会
攝影機	撮影機
攝影現場	撮影現場
攝影者	撮影者
攪	撹
收	収
效	効
敕	勅
敘	叙
數	数
斷	断
晉	晋
晚	晩
晝	昼
暨	曁
曆	暦
曉	暁
曾	曽
會	会
枡	桝
查	査
條	条
棧	桟
棱	稜 棱
榆	楡
榮	栄
槇島	槙島 槇島
槇島村	槙島村 槇島村
槇島町	槙島町 槇島町
槙島	槙島 槇島
槙島村	槙島村 槇島村
槙島町	槙島町 槇島町
樂	楽
樓	楼
樞	枢
樣	様
橫	横
檜隈	檜隈 桧隈
檜隈大內陵	檜隈大内陵 桧隈大内陵
檢	検
櫻	桜
權	権
欠缺	欠缺
次回預告	次回予告
歐	欧
歐洲	欧州
歡	歓
步	歩
歲	歳
歷	歴
歸	帰
殘	残
殼	殻
毆	殴
每	毎
氛圍	雰囲 氛囲
氣	気
污	汚
沒	没
沢澤	沢澤
沢澤砂羽	沢澤砂羽
涉	渉
淚	涙
淨	浄
淺	浅
渴	渇
溪	渓
溫	温
溼	湿
滯	滞
滿	満
潑	溌
潛	潜
澀	渋
澀下	渋下 澁下
澀久	渋久 澁久
澀井	渋井 澁井
澀佐	渋佐 澁佐
澀倉	渋倉 澁倉
澀原	渋原 澁原
澀口	渋口 澁口
澀坂	渋坂 澁坂
澀垂	渋垂 澁垂
澀尾	渋尾 澁尾
澀居	渋居
澀屋	渋屋 澁屋
澀山	渋山 澁山
澀岡	渋岡
澀川	渋川 澁川
澀市	渋市 澁市
澀庵	渋庵 澁庵
澀志	渋志
澀木	渋木 澁木
澀村	渋村 澁村
澀柿	渋柿 澁柿
澀桑	渋桑 澁桑
澀梨	渋梨
澀梨子	渋梨子 澁梨子
澀武	渋武 澁武
澀民	渋民
澀江	渋江 澁江
澀河	渋河
澀洞	渋洞
澀澤	渋沢 澁沢 渋澤 澁澤
澀瀨	渋瀬
澀生田	渋生田
澀田	渋田 澁田
澀田見	渋田見 澁田見
澀矢	渋矢
澀紙	渋紙
澀葉	渋葉 澁葉
澀藤	渋藤 澁藤
澀谷	渋谷 澁谷
澀路	渋路 澁路
澀野	渋野 澁野
澀鍬	渋鍬 澁鍬
澀間	渋間 澁間
澤	沢
濟	済
濤	涛
濱	浜
濾	沪
瀧	滝
瀨	瀬
灣	湾
炭礦	炭鉱
焰	焔
熙仁	熙仁 熈仁
燈	灯
燒	焼
營	営
爐	炉
爭	争
爲	為
牀	床
犧	犠
狀	状
狹	狭
獨	独
獵	猟
獸	獣
獻	献
瓣	弁
產	産
田澀	田渋 田澁
畫	画
當	当
疊	畳
疎	疏
痹	痺
瘦	痩
癡	痴
發	発
皋	皐
盜	盗
盜攝	盗撮
盡	尽
眞澀	眞渋 眞澁
真澀	真渋 真澁
碎	砕
祕	秘
祿	禄
禦	御
禪	禅
禮	礼
禰豆子	禰豆子
禱	祷
稅	税
稱	称
稻	稲
穎	頴
穗	穂
穩	穏
穰	穣
竈	竃
竈門禰豆子	竈門禰豆子
竊	窃
粹	粋
糉	粽
絕	絶
絕讚	絶賛
絲	糸
經	経
綠	緑
緖	緒
緣	縁
編輯	編集
縣	県
縱	縦
總	総
繡	繍
繩	縄
繪	絵
繫	繋
繼	継
續	続
纔	才
纖	繊
缺	欠
罐	缶
羣	群
聯	連
聰	聡
聲	声
聽	聴
肅	粛
脣	唇
脫	脱
腦	脳
腳	脚
膽	胆
臟	臓
臺	台
臺北輕鐵炭礦	台北軽鉄炭鉱
與	与
舉	挙
舊	旧
舍	舎
苗澀	苗渋
若者流出型過疎	若者流出型過疎
荔	茘
莊	荘
莖	茎
菸	煙
萊	莱
萬	万
蔣	蒋
蔥	葱
薰	薫
藏	蔵
藝	芸
藥	薬
蘆	芦
處	処
虛	虚
號	号
螢	蛍
蟲	虫
蠟	蝋
蠶	蚕
蠻	蛮
行政區劃	行政区画
行政區畫	行政区画
裝	装
覺	覚
覽	覧
觀	観
觸	触
說	説
謠	謡
證	証
譯	訳
譽	誉
讀	読
變	変
讓	譲
豐	豊
豫	予
豫備	予備
豫備役	予備役
豫告	予告
豫定	予定
豫定地	予定地
豫想	予想
豫感	予感
豫科	予科
豫科練	予科練
豫科練之歌	予科練之歌
豫算	予算
豫言	予言
豫言書	予言書
豫訂	予定
豫選	予選
豫防	予防
貓	猫
貳	弐
賣	売
賴	頼
贊	賛
贗	贋
足禰	足禰
踐	践
車輛	車両
輕	軽
輛	輌
轉	転
辨	弁
辭	辞
辯	弁
過疎	過疎
過疎化	過疎化
過疎地域	過疎地域
過疎地域自立促進特別措置法	過疎地域自立促進特別措置法
過疎對策	過疎対策
過疎對策關聯法	過疎対策関連法
過疎法	過疎法
過疎物語	過疎物語
遞	逓
遥	遙
遲	遅
邊	辺
鄉	郷
酢	醋
醉	酔
醫	医
醬	醤
醱	醗
釀	醸
釋	釈
鋪	舗
錄	録
錢	銭
鍊	錬
鐵	鉄
鑄	鋳
鑛	鉱
閱	閲
關	関
陷	陥
隨	随
險	険
隱	隠
集落分化型過疎	集落分化型過疎
雙	双
雜	雑
雞	鶏
霸	覇
靈	霊
靜	静
預備	予備
預備役	予備役
預告	予告
預定	予定
預定地	予定地
預想	予想
預感	予感
預科	予科
預科練	予科練
預科練之歌	予科練之歌
預算	予算
預言	予言
預言書	予言書
預訂	予定
預選	予選
預防	予防
顏	顔
顯	顕
飛驒	飛騨 飛驒
飛驒一宮水無神社	飛騨一宮水無神社 飛驒一宮水無神社
飛驒三大祭	飛騨三大祭 飛驒三大祭
飛驒事務所	飛騨事務所 飛驒事務所
飛驒古川	飛騨古川 飛驒古川
飛驒古川郵便局	飛騨古川郵便局 飛驒古川郵便局
飛驒古川驛	飛騨古川駅 飛驒古川駅
飛驒国司家	飛騨國司家 飛驒國司家
飛驒國	飛騨國 飛驒國
飛驒國分寺	飛騨国分寺 飛驒国分寺
飛驒國司	飛騨國司 飛驒國司
飛驒地域	飛騨地域 飛驒地域
飛驒地方	飛騨地方 飛驒地方
飛驒地震	飛騨地震 飛驒地震
飛驒天文台	飛騨天文台 飛驒天文台
飛驒守	飛騨守 飛驒守
飛驒守護	飛騨守護 飛驒守護
飛驒山	飛騨山 飛驒山
飛驒山脈	飛騨山脈 飛驒山脈
飛驒川	飛騨川 飛驒川
飛驒川流域	飛騨川 飛驒川
飛驒市	飛騨市 飛驒市
飛驒市圖書館	飛騨市図書館 飛驒市図書館
飛驒市森林公園	飛騨市森林公園 飛驒市森林公園
飛驒市民病院	飛騨市民病院 飛驒市民病院
飛驒市神岡圖書館	飛騨市神岡図書館 飛驒市神岡図書館
飛驒市立	飛騨市立 飛驒市立
飛驒木曾川國定公園	飛騨木曽川国定公園 飛驒木曽川国定公園
飛驒森林管理署	飛騨森林管理署 飛驒森林管理署
飛驒溫泉鄉	飛騨温泉郷 飛驒温泉郷
飛驒神岡高等學校	飛騨神岡高等学校 飛驒神岡高等学校
飛驒縣	飛騨県 飛驒県
飛驒總社	飛騨総社 飛驒総社
飛驒自動車檢查登錄事務所	飛騨自動車検査登録事務所 飛驒自動車検査登録事務所
飛驒警察署	飛騨警察署 飛驒警察署
飛驒辯	飛騨弁 飛驒弁
飛驒高地	飛騨高地 飛驒高地
飛驒高山	飛騨高山 飛驒高山
飛驒高山藩	飛騨高山藩 飛驒高山藩
餘	余
騷	騒
驅	駆
驗	験
驛	駅
髓	髄
體	体
髮	髪
鬥	闘
鱉	鼈
鷗	鴎
鹼	鹸
鹽	塩
麥	麦
麪	麺
麴	麹
黃	黄
黑	黒
默	黙
點	点
黨	党
齊	斉
齋	斎
齒	歯
齡	齢
龍	竜
龜	亀